NO ./textures/sky.png
SO ./textures/desert.png
EA ./textures/forrest.png
WE ./textures/ocean.png

C 66,191,221
F 240,246,246

         1111111111111111111111111
         10000000000000000000000N1
         1000000000000000000000001
         1000000000000000000000001
         1111111111111111111111111