1111111111
1000000001
1010000001
10000N1001
1000000011
1010000111
1010000001
1010000001
1010000001
1111111111
